###############################
#p     f* *    *   *  * * *   #
# # # #*# # #*#*# # # #*#*#*# #
#   s     ***  *   2  *   * * #
# # # # # #*# # #*#*# # # # #*#
#     1      **  *  *        *#
# # # # # # # # # #*# #*# # # #
#*  *      *  b      *     ** #
# # # # #*# # # #*#*# # # # # #
#*    **  *       *  1   **   #
# #*# # # # # # #*# # # # # # #
#        1  *   *  *   2     x#
###############################


