###############################
#p     b* *  1 *   *  * * *   #
# ### #*#f# #*#*# # # #*#*#*# #
#   *     ***  *      *   * * #
# ### * # #s# # #*#*# # # # #*#
#            **  *  *        *#
# # ##### * * # * #*###*### # #
#*  *      *  *      *     ** #
# # # # #*# # # #*#*####*## # #
#*    **  *    1  *      **   #
# #*# ### # # # #*# # # # # # #
#        1  *   *  * 1       x#
###############################